7
7
F F F F F F G
F F B F F F F
P F F F F F F
W W W W W W W
F F F F F F G
P F B F F F F
F F F F F F F
[0,1,2,3,4,5,6,7,8,9]
[0,
1,
2,
3,
4,
5,
6,
7,
8,
9]