7
7
F F G W F F F
F F F F F B F
F F W W W W W
F F W W F F W
F F F F F F W
F B W W W G W
F F W W W P W


[0,1,2,3,4,5,6,7,8,9]
[0,
1,
2,
3,
4,
5,
6,
7,
8,
9]