9
6
P I I I W I I I I
I I I I B I I I I
I I I W I I I I I
W I I I I I I I G
I I I B I I I I G
I I I I I I I I I


[0,1,2,3,4,5,6,7,8,9]
[0,
1,
2,
3,
4,
5,
6,
7,
8,
9]