7
7
W F F F F G F
P F F B B F F
F F G W G F F
F B W W W B F
F F G W G F F
F F F B F F F
F F F F F F F


[0,1,2,3,4,5,6,7,8,9]
[0,
1,
2,
3,
4,
5,
6,
7,
8,
9]