7
9
P F G W W W W
F F F G W W W
F F F F G W W
W B F F F G W
F F B F F F G
F F F B F F F
W F F F B F F
W W F F F B F
W W W F F W F


[0,1,2,3,4,5,6,7,8,9]
[0,
1,
2,
3,
4,
5,
6,
7,
8,
9]