12
8
F F F F F F F F F F F F
F F F F F F F F F F F F
F F F F F F B F F F F F
F F F F F F W F F F F F
F F F F W W W F F F F F
F F F G G F B F P F F F
F F F F G F B F F F F F
F F F F F F F F F F F F

[0,1,2,3,4,5,6,7,8,9]
[0,
1,
2,
3,
4,
5,
6,
7,
8,
9]