8
8
P F F W F F F F
F F F W F F F F
F F F W F F B F
F F F W F F F F
F F F W G F F F
F F F W W W B B
F F F F F F F F
G F F F F F F G

[0,1,2,3,4,5,6,7,8,9]
[0,
1,
2,
3,
4,
5,
6,
7,
8,
9]