8
8
FFFFFFFF
FFWFPFFF
FFFFFFFF
FFWWWFFF
FFFFFFFF
FFFBBFFF
FFFGGFFF
FFFFFFFF